
### File header must not be modified
### This file must be encoded into UTF-8.
### comments start with ### not single #
### This file is made using help from a tutorial at link:
### http://www.studymongolian.net/technical/how-to-create-linux-input-method-editor/
### Derive from the format of SCIM Table, so you can modify the table from
### scim-tables' table
SCIM_Generic_Table_Phrase_Library_TEXT
VERSION_1_0

BEGIN_DEFINITION

LICENSE = 0BSD
UUID = f67b50f3-a3a7-4555-ba34-58706e423f71
SERIAL_NUMBER = 20200514
NAME = Toki Pona Sitelen Emoji
DESCRIPTION = This is to write Toki Pona in Sitelen Emoji
LANGUAGES = en_US
AUTHOR = Dev Bali <devbali02@gmail.com>
STATUS_PROMPT = TP
VALID_INPUT_CHARS = aeiounwtpsjklmAEIOUNWTPSJKLM.:_
LAYOUT = us
MAX_KEY_LENGTH = 10
AUTO_COMMIT = FALSE
DEF_FULL_WIDTH_PUNCT = FALSE
DEF_FULL_WIDTH_LETTER = FALSE
USER_CAN_DEFINE_PHRASE = TRUE
PINYIN_MODE = TRUE
DYNAMIC_ADJUST = FALSE

END_DEFINITION


BEGIN_TABLE
_	ğŸ”£	1
.	â–	1
:	â—	1

a	â—	1
akesi	ğŸ¦	1
ala	âŒ	1
alasa	ğŸ¹	1
ale	â™¾ï¸	1
ali	â™¾ï¸	1
anpa	â¬‡ï¸	1
ante	ğŸ”€	1
anu	â˜¯ï¸	1
apeja	ğŸ˜¢	1
awen	âš“	1
e	â©	1
en	â•	1
esun	ğŸ›’	1
ijo	ğŸš	1
ike	ğŸ‘	1
ilo	âš™ï¸	1
insa	âºï¸	1
jaki	ğŸ’©	1
jan	ğŸ‘¤	1
jelo	ğŸ’›	1
jo	ğŸ‘œ	1
kala	ğŸŸ	1
kalama	ğŸ”ˆ	1
kama	ğŸš¶	1
kasi	ğŸŒ´	1
ken	ğŸ’ª	1
kepeken	ğŸ”§	1
kijetesantakalu	ğŸ¦	1
kili	ğŸ	1
kin	â•	1
kipisi	âœ‚ï¸	1
kiwen	ğŸ’	1
ko	ğŸ¦	1
kon	ğŸ’¨	1
kule	ğŸŒˆ	1
kulupu	ğŸ‘¥	1
kute	ğŸ‘‚	1
la	ğŸ”¼	1
lape	ğŸ˜´	1
laso	ğŸ”µ	1
lawa	ğŸ˜¶	1
leko	ğŸ§±	1
len	ğŸ‘•	1
lete	â„ï¸	1
li	â–¶ï¸	1
lili	ğŸ­	1
linja	ã€°ï¸	1
linluwi	ğŸŒ	1
lipu	ğŸ“„	1
loje	ğŸ”´	1
lon	ğŸ“	1
luka	âœ‹	1
lukin	ğŸ‘€	1
lupa	ğŸ•³ï¸	1
ma	ğŸï¸	1
majuna	ğŸ‘µ	1
mama	ğŸ‘ª	1
mani	ğŸ’°	1
meli	ğŸ‘§	1
mi	ğŸ‘ˆ	1
mije	ğŸ‘¨	1
moku	ğŸ½ï¸	1
moli	ğŸ’€	1
monsi	â¬…ï¸	1
monsuta	ğŸ‘¹	1
mu	ğŸ˜¹	1
mulapisu	ğŸ•	1
mun	ğŸŒ™	1
musi	ğŸ˜ƒ	1
mute	ğŸ‘	1
namako	ğŸ§‚	1
nanpa	#ï¸âƒ£	1
nasa	ğŸŒ€	1
nasin	ğŸ›£ï¸	1
nena	ğŸ—»	1
ni	ğŸ‘‡	1
nimi	ğŸ’¬	1
noka	ğŸ¦µ	1
o	ğŸ‘‹	1
oko	ğŸ‘ï¸	1
olin	ğŸ’•	1
ona	ğŸ‘†	1
open	ğŸ”“	1
pakala	ğŸ’¥	1
pake	ğŸš§	1
pali	âœŠ	1
palisa	ğŸ“	1
pan	ğŸ	1
pana	ğŸ“¤	1
pi	â¹ï¸	1
pilin	â¤ï¸	1
pimeja	âš«	1
pini	ğŸ	1
pipi	ğŸ	1
poka	â†”ï¸	1
poki	ğŸ“¦	1
pona	ğŸ‘	1
powe	ğŸ§	1
pu	ğŸ“–	1
sama	âš–ï¸	1
seli	ğŸ”¥	1
selo	ğŸ”²	1
seme	â“	1
sewi	â¬†ï¸	1
sijelo	ğŸ‹ï¸	1
sike	â­•	1
sin	ğŸ	1
sina	ğŸ‘‰	1
sinpin	â¡ï¸	1
sitelen	ğŸ–¼ï¸	1
sona	ğŸ§ 	1
soweli	ğŸ’	1
suli	ğŸ˜	1
suno	â˜€ï¸	1
supa	ğŸ›ï¸	1
suwi	ğŸ­	1
tan	â†©ï¸	1
taso	ğŸ¤”	1
tawa	â†ªï¸	1
telo	ğŸ’§	1
tenpo	â°	1
toki	ğŸ—£ï¸	1
tomo	ğŸ 	1
tonsi	â™	1
tu	âœŒï¸	1
unpa	ğŸ†	1
uta	ğŸ‘„	1
utala	âš”ï¸	1
walo	âšª	1
wan	â˜ï¸	1
waso	ğŸ¦…	1
wawa	âš¡	1
weka	ğŸ›«	1
wile	ğŸ’­	1
Akanisan	ğŸ‡¦ğŸ‡«	1
Olan	ğŸ‡¦ğŸ‡½	1
Sipe	ğŸ‡¦ğŸ‡±	1
Sasali	ğŸ‡©ğŸ‡¿	1
Amewikansamowa	ğŸ‡¦ğŸ‡¸	1
Antola	ğŸ‡¦ğŸ‡©	1
Ankola	ğŸ‡¦ğŸ‡´	1
Anwila	ğŸ‡¦ğŸ‡®	1
Antasika	ğŸ‡¦ğŸ‡¶	1
Ansika	ğŸ‡¦ğŸ‡¬	1
Alensina	ğŸ‡¦ğŸ‡·	1
Aja	ğŸ‡¦ğŸ‡²	1
Alupa	ğŸ‡¦ğŸ‡¼	1
Asenson	ğŸ‡¦ğŸ‡¨	1
Oselija	ğŸ‡¦ğŸ‡º	1
Esalasi	ğŸ‡¦ğŸ‡¹	1
Asepasan	ğŸ‡¦ğŸ‡¿	1
Pawama	ğŸ‡§ğŸ‡¸	1
Palani	ğŸ‡§ğŸ‡­	1
Panla	ğŸ‡§ğŸ‡©	1
Papeto	ğŸ‡§ğŸ‡§	1
Pelalusi	ğŸ‡§ğŸ‡¾	1
Pesije	ğŸ‡§ğŸ‡ª	1
Pelis	ğŸ‡§ğŸ‡¿	1
Penen	ğŸ‡§ğŸ‡¯	1
Pemuta	ğŸ‡§ğŸ‡²	1
Tukika	ğŸ‡§ğŸ‡¹	1
Polipa	ğŸ‡§ğŸ‡´	1
Posan	ğŸ‡§ğŸ‡¦	1
Posuwana	ğŸ‡§ğŸ‡¼	1
Pupetoja	ğŸ‡§ğŸ‡»	1
Pasila	ğŸ‡§ğŸ‡·	1
Pijot	ğŸ‡®ğŸ‡´	1
Pisinalan	ğŸ‡»ğŸ‡¬	1
Pune	ğŸ‡§ğŸ‡³	1
Pokasi	ğŸ‡§ğŸ‡¬	1
Pukinapaso	ğŸ‡§ğŸ‡«	1
Upulunsi	ğŸ‡§ğŸ‡®	1
Kanpusi	ğŸ‡°ğŸ‡­	1
Kamelun	ğŸ‡¨ğŸ‡²	1
Kanata	ğŸ‡¨ğŸ‡¦	1
Kanalija	ğŸ‡®ğŸ‡¨	1
Kapupesi	ğŸ‡¨ğŸ‡»	1
Kalibinetelan	ğŸ‡§ğŸ‡¶	1
Kesimen	ğŸ‡°ğŸ‡¾	1
Santapiken	ğŸ‡¨ğŸ‡«	1
Sejuta	ğŸ‡ªğŸ‡¦	1
Sate	ğŸ‡¹ğŸ‡©	1
Sile	ğŸ‡¨ğŸ‡±	1
Sonko	ğŸ‡¨ğŸ‡³	1
Kilima	ğŸ‡¨ğŸ‡½	1
Kipeton	ğŸ‡¨ğŸ‡µ	1
Koko	ğŸ‡¨ğŸ‡¨	1
Kolonpa	ğŸ‡¨ğŸ‡´	1
Komo	ğŸ‡°ğŸ‡²	1
Jakonko	ğŸ‡¨ğŸ‡¬	1
Konko	ğŸ‡¨ğŸ‡©	1
Kukialani	ğŸ‡¨ğŸ‡°	1
Kosalika	ğŸ‡¨ğŸ‡·	1
Kosiwa	ğŸ‡¨ğŸ‡®	1
Lowasi	ğŸ‡­ğŸ‡·	1
Kupa	ğŸ‡¨ğŸ‡º	1
Kulusu	ğŸ‡¨ğŸ‡¼	1
Kiposi	ğŸ‡¨ğŸ‡¾	1
Seki	ğŸ‡¨ğŸ‡¿	1
Tansi	ğŸ‡©ğŸ‡°	1
Tekokasija	ğŸ‡©ğŸ‡¬	1
Sipusi	ğŸ‡©ğŸ‡¯	1
Tomini	ğŸ‡©ğŸ‡²	1
Tominika	ğŸ‡©ğŸ‡´	1
Ekato	ğŸ‡ªğŸ‡¨	1
Masu	ğŸ‡ªğŸ‡¬	1
Sapato	ğŸ‡¸ğŸ‡»	1
Kinejekatolija	ğŸ‡¬ğŸ‡¶	1
Eliteja	ğŸ‡ªğŸ‡·	1
Esi	ğŸ‡ªğŸ‡ª	1
Sawasi	ğŸ‡¸ğŸ‡¿	1
Isijopija	ğŸ‡ªğŸ‡¹	1
Elopa	ğŸ‡ªğŸ‡º	1
Pokan	ğŸ‡«ğŸ‡°	1
Foja	ğŸ‡«ğŸ‡´	1
Pisi	ğŸ‡«ğŸ‡¯	1
Sumi	ğŸ‡«ğŸ‡®	1
Kanse	ğŸ‡«ğŸ‡·	1
Kijan	ğŸ‡¬ğŸ‡«	1
Polinesi	ğŸ‡µğŸ‡«	1
Telota	ğŸ‡¹ğŸ‡«	1
Kapon	ğŸ‡¬ğŸ‡¦	1
Kanpija	ğŸ‡¬ğŸ‡²	1
Katelo	ğŸ‡¬ğŸ‡ª	1
Tosi	ğŸ‡©ğŸ‡ª	1
Kana	ğŸ‡¬ğŸ‡­	1
Sipata	ğŸ‡¬ğŸ‡®	1
Elena	ğŸ‡¬ğŸ‡·	1
Kalalinuna	ğŸ‡¬ğŸ‡±	1
Kenata	ğŸ‡¬ğŸ‡©	1
Watalu	ğŸ‡¬ğŸ‡µ	1
Wan	ğŸ‡¬ğŸ‡º	1
Katemala	ğŸ‡¬ğŸ‡¹	1
Kensi	ğŸ‡¬ğŸ‡¬	1
Kine	ğŸ‡¬ğŸ‡³	1
Kinepisa	ğŸ‡¬ğŸ‡¼	1
Kajan	ğŸ‡¬ğŸ‡¾	1
Awisi	ğŸ‡­ğŸ‡¹	1
Imi	ğŸ‡­ğŸ‡²	1
Ontula	ğŸ‡­ğŸ‡³	1
Onkon	ğŸ‡­ğŸ‡°	1
Mosijo	ğŸ‡­ğŸ‡º	1
Isilan	ğŸ‡®ğŸ‡¸	1
Palata	ğŸ‡®ğŸ‡³	1
Intonesija	ğŸ‡®ğŸ‡©	1
Ilan	ğŸ‡®ğŸ‡·	1
Ilakija	ğŸ‡®ğŸ‡¶	1
Alan	ğŸ‡®ğŸ‡ª	1
Manin	ğŸ‡®ğŸ‡²	1
Isale	ğŸ‡®ğŸ‡±	1
Italija	ğŸ‡®ğŸ‡¹	1
Sameka	ğŸ‡¯ğŸ‡²	1
Nijon	ğŸ‡¯ğŸ‡µ	1
Jesi	ğŸ‡¯ğŸ‡ª	1
Utun	ğŸ‡¯ğŸ‡´	1
Kasatan	ğŸ‡°ğŸ‡¿	1
Kenja	ğŸ‡°ğŸ‡ª	1
Kilipasi	ğŸ‡°ğŸ‡®	1
Kosopa	ğŸ‡½ğŸ‡°	1
Kuwasi	ğŸ‡°ğŸ‡¼	1
Kikitan	ğŸ‡°ğŸ‡¬	1
Laju	ğŸ‡±ğŸ‡¦	1
Lawi	ğŸ‡±ğŸ‡»	1
Lunpan	ğŸ‡±ğŸ‡§	1
Lesoto	ğŸ‡±ğŸ‡¸	1
Lapewija	ğŸ‡±ğŸ‡·	1
Lipija	ğŸ‡±ğŸ‡¾	1
Lisensan	ğŸ‡±ğŸ‡®	1
Lijatuwa	ğŸ‡±ğŸ‡¹	1
Lusepu	ğŸ‡±ğŸ‡º	1
Omun	ğŸ‡²ğŸ‡´	1
Maketonija	ğŸ‡²ğŸ‡°	1
Malakasi	ğŸ‡²ğŸ‡¬	1
Malawi	ğŸ‡²ğŸ‡¼	1
Malasija	ğŸ‡²ğŸ‡¾	1
Sipeji	ğŸ‡²ğŸ‡»	1
Mali	ğŸ‡²ğŸ‡±	1
Mata	ğŸ‡²ğŸ‡¹	1
Maje	ğŸ‡²ğŸ‡­	1
Masini	ğŸ‡²ğŸ‡¶	1
Mulitanija	ğŸ‡²ğŸ‡·	1
Mowisi	ğŸ‡²ğŸ‡º	1
Majo	ğŸ‡¾ğŸ‡¹	1
Mesiko	ğŸ‡²ğŸ‡½	1
Makonise	ğŸ‡«ğŸ‡²	1
Motowa	ğŸ‡²ğŸ‡©	1
Monako	ğŸ‡²ğŸ‡¨	1
Monkolu	ğŸ‡²ğŸ‡³	1
Sinakola	ğŸ‡²ğŸ‡ª	1
Monsale	ğŸ‡²ğŸ‡¸	1
Malipe	ğŸ‡²ğŸ‡¦	1
Mosanpi	ğŸ‡²ğŸ‡¿	1
Mijama	ğŸ‡²ğŸ‡²	1
Namipija	ğŸ‡³ğŸ‡¦	1
Nawelo	ğŸ‡³ğŸ‡·	1
Nepa	ğŸ‡³ğŸ‡µ	1
Netelan	ğŸ‡³ğŸ‡±	1
Nupekaletoni	ğŸ‡³ğŸ‡¨	1
Nusilan	ğŸ‡³ğŸ‡¿	1
Nikalawa	ğŸ‡³ğŸ‡®	1
Nise	ğŸ‡³ğŸ‡ª	1
Naselija	ğŸ‡³ğŸ‡¬	1
Niwe	ğŸ‡³ğŸ‡º	1
Nopo	ğŸ‡³ğŸ‡«	1
Pukoson	ğŸ‡°ğŸ‡µ	1
Majana	ğŸ‡²ğŸ‡µ	1
Nosiki	ğŸ‡³ğŸ‡´	1
Uman	ğŸ‡´ğŸ‡²	1
Pakisan	ğŸ‡µğŸ‡°	1
Pela	ğŸ‡µğŸ‡¼	1
Pilisin	ğŸ‡µğŸ‡¸	1
Panama	ğŸ‡µğŸ‡¦	1
Papuwanijukini	ğŸ‡µğŸ‡¬	1
Palakawi	ğŸ‡µğŸ‡¾	1
Pelu	ğŸ‡µğŸ‡ª	1
Pilipina	ğŸ‡µğŸ‡­	1
Piken	ğŸ‡µğŸ‡³	1
Posuka	ğŸ‡µğŸ‡±	1
Potuke	ğŸ‡µğŸ‡¹	1
Puwetoliko	ğŸ‡µğŸ‡·	1
Kita	ğŸ‡¶ğŸ‡¦	1
Lajenon	ğŸ‡·ğŸ‡ª	1
Lomani	ğŸ‡·ğŸ‡´	1
Losi	ğŸ‡·ğŸ‡º	1
Luwanta	ğŸ‡·ğŸ‡¼	1
Samowa	ğŸ‡¼ğŸ‡¸	1
Samalino	ğŸ‡¸ğŸ‡²	1
Santume	ğŸ‡¸ğŸ‡¹	1
Sawusi	ğŸ‡¸ğŸ‡¦	1
Seneka	ğŸ‡¸ğŸ‡³	1
Sopisi	ğŸ‡·ğŸ‡¸	1
Sese	ğŸ‡¸ğŸ‡¨	1
Sijelalijon	ğŸ‡¸ğŸ‡±	1
Sinkapo	ğŸ‡¸ğŸ‡¬	1
Sinmaten	ğŸ‡¸ğŸ‡½	1
Lowenki	ğŸ‡¸ğŸ‡°	1
Lowensina	ğŸ‡¸ğŸ‡®	1
Solomon	ğŸ‡¸ğŸ‡§	1
Somalija	ğŸ‡¸ğŸ‡´	1
Setapika	ğŸ‡¿ğŸ‡¦	1
Sajoja	ğŸ‡¬ğŸ‡¸	1
Anku	ğŸ‡°ğŸ‡·	1
Sasutan	ğŸ‡¸ğŸ‡¸	1
Epanja	ğŸ‡ªğŸ‡¸	1
Lanka	ğŸ‡±ğŸ‡°	1
Sepatelemi	ğŸ‡§ğŸ‡±	1
Sateline	ğŸ‡¸ğŸ‡­	1
Sankinipi	ğŸ‡°ğŸ‡³	1
Senlusi	ğŸ‡±ğŸ‡¨	1
Sematan	ğŸ‡²ğŸ‡«	1
Sepemiko	ğŸ‡µğŸ‡²	1
Kenedin	ğŸ‡»ğŸ‡¨	1
Sutan	ğŸ‡¸ğŸ‡©	1
Siliname	ğŸ‡¸ğŸ‡·	1
Sepapa	ğŸ‡¸ğŸ‡¯	1
Wensa	ğŸ‡¸ğŸ‡ª	1
Suwasi	ğŸ‡¨ğŸ‡­	1
Sulija	ğŸ‡¸ğŸ‡¾	1
Tawan	ğŸ‡¹ğŸ‡¼	1
Tojikiton	ğŸ‡¹ğŸ‡¯	1
Tansanija	ğŸ‡¹ğŸ‡¿	1
Tawi	ğŸ‡¹ğŸ‡­	1
Simololosa	ğŸ‡¹ğŸ‡±	1
Toko	ğŸ‡¹ğŸ‡¬	1
Tokela	ğŸ‡¹ğŸ‡°	1
Tona	ğŸ‡¹ğŸ‡´	1
Sinita	ğŸ‡¹ğŸ‡¹	1
Siten	ğŸ‡¹ğŸ‡¦	1
Tunisi	ğŸ‡¹ğŸ‡³	1
Tuki	ğŸ‡¹ğŸ‡·	1
Temenitan	ğŸ‡¹ğŸ‡²	1
Tekeko	ğŸ‡¹ğŸ‡¨	1
Tuwalu	ğŸ‡¹ğŸ‡»	1
Mewikalan	ğŸ‡ºğŸ‡²	1
Pijenalan	ğŸ‡»ğŸ‡®	1
Ukanta	ğŸ‡ºğŸ‡¬	1
Ukawina	ğŸ‡ºğŸ‡¦	1
Alimala	ğŸ‡¦ğŸ‡ª	1
Juke	ğŸ‡¬ğŸ‡§	1
Mewika	ğŸ‡ºğŸ‡¸	1
Ulukawi	ğŸ‡ºğŸ‡¾	1
Opekiton	ğŸ‡ºğŸ‡¿	1
Wanuwatu	ğŸ‡»ğŸ‡º	1
Wasikano	ğŸ‡»ğŸ‡¦	1
Penesuwela	ğŸ‡»ğŸ‡ª	1
Wije	ğŸ‡»ğŸ‡³	1
Upemoputuna	ğŸ‡¼ğŸ‡«	1
Asala	ğŸ‡ªğŸ‡­	1
Jamanija	ğŸ‡¾ğŸ‡ª	1
Sanpija	ğŸ‡¿ğŸ‡²	1
Sinpapuwe	ğŸ‡¿ğŸ‡¼	1
Inli	ğŸ´ó §ó ¢ó ¥ó ®ó §ó ¿	1
Sukosi	ğŸ´ó §ó ¢ó ³ó £ó ´ó ¿	1
Kinla	ğŸ´ó §ó ¢ó ·ó ¬ó ³ó ¿	1
Katala	ğŸ´ó ¥ó ³ó £ó ´ó ¿	1
Esuka	ğŸ´ó ¥ó ³ó °ó ¶ó ¿	1
Peson	ğŸ´ó ¦ó ²ó ¢ó ²ó ¥ó ¿	1
Kusala	ğŸ´ó ©ó ®ó §ó ªó ¿	1
Kuli	ğŸ´ó ©ó ²ó €±ó €¶ó ¿	1
Po	ğŸ´ó £ó ®ó €µó €´ó ¿	1
Amelika	ğŸŒ	1
Apika	ğŸŒ	1
Asija	ğŸŒ	1
Osejanija	ğŸŒŠ	1
END_TABlE
